0 1 h 1 1 1 1 1 0 0
0 c 1 1 1 1 1 1 g m
0 0 0 1 1 1 1 1 0 0
1 1 g 1 1 1 1 1 0 0
1 0 0 0 0 0 m 1 1 d
1 1 1 1 1 0 1 0 0 0
1 c m 1 g 1 1 c 1 c
0 0 0 0 0 0 0 0 0 0
0 0 0 0 0 0 0 0 0 0
0 0 0 0 0 0 0 0 0 0